################################
#..............................#
#.########..#####...######.....#
#..#.....#.....#...............#
#..#############..#########....#
#..#.....#.....#...............#
#..#######...########.#######..#
#..............................#
#....#######...#######.........#
#..............................#
#.######.########...#########..#
#..#.....#.....#...............#
#..#######..#######...#####....#
#..#.....#.....#...............#
#..#..#######..########........#
#..............................#
#..............................#
#..#..#######..########........#
#..#.....#.....#...............#
#..#######..#######...#####....#
#..#.....#.....#...............#
#.######.########...#########..#
#..#.....#.....#...............#
#....#######...#######.........#
#..............................#
#..#######...########.#######..#
#..#.....#.....#...............#
#..#############..#########....#
#..#.....#.....#...............#
#.########..#####...######.....#
#..#.....#.....#...............#
################################
