####################
#..................#
#.####.##.##.####.#
#.#..............##
#.#.##########.#..#
#...#........#.#..#
###.#.######.#.####
#...#.#....#.#....#
#.###.#.##.#.###..#
#.....#.##.#......#
#.###.#....######.#
#...#.##########..#
#.#..............##
#.####.##.##.####.#
#..................#
####################
