####################
#..................#
#.................#
#....########.....#
#....#......#.....#
#....#......#.....#
#....#......#.....#
#....########.....#
#.................#
#.......##........#
#.......##........#
#.................#
#....########.....#
#....#......#.....#
#....#......#.....#
####################
