####################
#..................#
#..##..####..##...#
#..##..#..#..##...#
#......#..#.......#
#......####.......#
#.................#
#....########.....#
#.................#
#......####.......#
#......#..#.......#
#..##..#..#..##...#
#..##..####..##...#
#..................#
#..................#
####################
