################################
#..............................#
#.############################.#
#.#..........................#.#
#.#..........................#.#
#.#..........................#.#
#.#..........................#.#
#.#..........................#.#
#.#..........................#.#
#.#..........................#.#
#.#..........................#.#
#.#..........................#.#
#.#..........................#.#
#.#..........................#.#
#.#..........................#.#
#.#..........................#.#
#.#..........................#.#
#.#..........................#.#
#.#..........................#.#
#.#..........................#.#
#.#..........................#.#
#.#..........................#.#
#.#..........................#.#
#.#..........................#.#
#.#..........................#.#
#.#..........................#.#
#.#..........................#.#
#.#..........................#.#
#.#..........................#.#
#.############################.#
#..............................#
################################
